  \AB|               |
CD \ | 00  01  11  10|
-----+---+---+---+---+
   00| 1 | 1 | 0 | 0 |
-----+---+---+---+---+
   01| x | 1 | x | 0 |
-----+---+---+---+---+
   11| 0 | 0 | x | 1 |
-----+---+---+---+---+
   10| 0 | 0 | x | 1 |
-----+---+---+---+---+

Prime implicant:a'c',ac,bc'd
Essential prime implicant:a'c',ac
F(A,B,C,D)=a'c'+ac